other than : кроме как
one another : друг друга
otherwise : иначе
in view of : ввиду
a number of : ряд
both : оба
to do away with : уничтожить, покончить с
to be subject to : подвергаться чему-либо
in addition to : в дополнение к
to be of interest : представлять интерес
now that : теперь когда
owing to : благодаря
a means : способ, средство
the only : единственный
by all means : во что бы то ни стало
to be of help : оказывать помощь
a subject : тема, предмет
to matter : иметь значение
in spite of : несмотря на
to be of importance : иметь значение
to have nothing to do with : не иметь ничего общего
both ... and ... : как ... так и
to be of value : представлять ценность
to have to do with : иметь дело с
in accordance with : в оответствии с
only : только
as to : что касается
to have much to do with : иметь много общего
a mean : средняя величина / число
to mean : значит, иметь в виду
according to : согласно
mean : средний
each other : друг друга
subject to : подверженный, подлежащий
in doing so : при этом
the number of : клоичество
in relation to : относительо
a matter of dispute : спорный вопрос
a number : число
by means of : при помощи
save : за исключением того, что
to do without : обходиться без
with respect to : по отношению к
as it does : фактически
provided (that) : при условии, если
no matter : безразлично
apart from : помимо
a matter : вещество, материя, материал
because of : из-за
given : при условии, что
a subject matter : основная тема, содержание
by virtue of : посредством
by no means : ни в коем случае
to number : нумеровать
to subject : подвергать, подчинять
providing that : при условии, если
thanks to : благодаря
due to : из-за
